return0,revert1,revert2,revert3,revert4,revert5,revert6,revert7,revert8,revert9,mo1,mo2,mo3,mo4,mo5,mo6,mo7,mo8,mo9,mo10,mo11
12,54,-170,-22,19,-131,54,-170,54,-170,-5,8,3,-29,-64,-57,-1,-3,-3,2,-6
-98,58,-57,-27,86,-138,86,-138,86,-138,42,-67,-25,-110,-68,-44,-19,61,-44,-86,-19
-288,128,-180,-49,-95,-319,-95,-130,-95,-319,-34,-1,-35,-210,-210,-255,-154,-50,-50,-16,-15
-114,804,142,150,598,151,598,151,598,151,18,-39,-21,-307,-120,70,-129,-30,-30,-48,-9
-17,158,-85,24,765,103,765,103,765,103,0,-65,-65,-219,-216,-216,-166,-69,-69,-69,-4
62,209,-24,0,902,52,902,52,902,52,-5,-20,-25,0,0,-105,-182,-32,-32,-27,-7
-39,199,-17,154,1003,77,1003,77,1003,77,6,25,31,50,2,19,39,21,31,25,0
10,-45,-257,-253,148,-265,755,-265,755,-265,-1,-19,-20,-150,-159,-150,-134,-19,-19,-18,1
210,172,77,120,181,-146,874,-146,874,-146,10,41,51,223,214,120,120,108,80,70,29
54,532,-27,-16,702,384,797,384,600,384,0,-21,-21,-218,-176,-120,-120,-57,-28,-28,-7
119,153,2,152,782,53,791,53,612,53,-26,-25,-51,1,0,0,-25,-25,-51,-25,0
-34,288,74,86,1083,303,1083,303,454,303,-70,20,-50,-17,-17,-99,-17,-17,-49,21,1
-158,554,292,316,1363,524,1533,524,738,524,-55,-91,-146,0,0,0,-499,-3,-144,-89,2
130,84,-104,-14,803,191,1432,191,453,191,-7,-93,-100,-100,-100,-130,-125,-139,-100,-93,0
-73,173,-93,-81,750,9,1375,9,197,9,0,0,0,-237,-11,-17,-11,-59,0,0,0
-2,18,-142,101,414,-245,764,-245,21,-245,0,-15,-15,202,202,201,-139,-19,-19,-19,-4
113,92,-157,0,41,-249,594,-249,14,-249,12,0,12,193,100,100,132,41,12,0,0
-28,371,87,280,393,52,711,52,315,52,4,-10,-6,-49,-52,-31,-23,-6,-6,-10,0
-4,147,-39,-33,474,168,474,133,396,133,-7,-14,-21,28,28,-39,-33,-31,-31,-24,-10
-74,348,183,245,735,222,735,222,408,222,-27,20,-7,-389,-389,-170,-100,-86,-27,0,-20
-51,200,-158,189,563,33,585,33,198,33,-39,27,-12,-268,-450,-348,-150,-85,-39,0,-27
-32,150,-99,44,233,-183,560,-183,173,-183,25,0,25,-55,-75,-75,25,0,25,0,0
-109,204,-162,-155,318,-40,681,-40,293,-40,-55,-11,-66,-57,-57,-57,30,19,-57,-2,9
-43,210,-90,46,350,-130,408,-130,236,-130,-12,-26,-38,46,46,46,46,-88,-51,-39,-13
70,67,-241,-28,92,-363,117,-363,-23,-363,-14,-16,-30,0,0,0,-18,-15,-14,0,16
-28,110,-189,-78,120,-310,170,-310,30,-310,-23,-57,-80,11,11,10,-67,-67,-76,-53,4
-76,218,47,62,328,-62,353,-102,238,-102,-3,-22,-25,65,-26,-25,-2,-12,-25,-22,0
57,298,-214,-187,529,220,529,99,419,99,-7,-11,-18,-18,-28,-28,-32,-28,-18,-11,0
35,315,167,275,787,54,797,54,566,54,15,-14,1,52,67,67,67,-2,13,-2,12
-1,288,126,256,890,257,1000,257,518,257,20,30,50,-117,-120,1,87,60,50,30,0
-30,51,-358,43,475,-168,696,-168,-6,-168,53,22,75,-119,51,51,-170,31,30,-23,-45
24,102,-181,-111,135,-447,507,-447,-95,-447,0,-67,-67,17,117,-15,-16,-15,-33,-33,34
26,85,-224,-144,135,-414,419,-414,-62,-414,-8,-18,-26,7,18,-2,-18,-20,-28,-20,-2
-163,184,45,114,286,-263,319,-263,89,-263,-29,47,18,21,-59,-36,-36,29,19,48,1
158,102,-108,-16,185,-174,185,-364,-12,-364,-17,-46,-63,100,85,67,0,0,-60,-43,3
79,172,-398,15,-45,-354,5,-544,-192,-544,-124,-47,-171,120,120,89,55,0,-228,-104,-57
-93,367,189,102,555,-15,555,-15,191,-161,59,-4,55,468,468,252,101,101,101,42,46
119,-44,-267,-219,383,-187,383,-187,19,-333,28,-63,-35,460,460,229,29,67,-29,-57,6
24,320,-27,276,545,-105,545,-105,118,-171,-67,-53,-120,113,113,88,-323,-95,-127,-60,-7
-19,-14,-126,-64,234,-228,422,-228,-5,-294,15,-11,4,30,30,30,1,0,0,-15,-4
-127,0,-413,-35,-153,-578,72,-578,-364,-644,-41,26,-15,-386,-330,-330,-230,26,-15,26,0
61,-303,-765,-309,-738,-1238,-738,-1316,-1102,-1316,28,25,53,227,114,-18,-118,116,60,32,7
19,172,-58,47,-69,-980,-69,-1082,-868,-1082,1,6,7,115,47,44,50,43,16,15,9
44,244,-29,0,393,-696,393,-783,-647,-861,16,12,28,0,0,0,-77,93,42,26,14
-4,217,-129,-27,586,-117,586,-566,-454,-668,0,0,0,-409,-35,-27,-27,-6,-27,-27,-27
-1,497,206,224,904,189,904,-185,-136,-350,-14,-18,-32,-382,-186,-232,-131,-42,-42,-28,-10
61,314,137,269,957,391,1106,391,66,-148,14,-1,13,-78,-78,40,-25,10,14,0,1
-21,3,-407,-19,451,-149,820,-149,-220,-434,20,34,54,13,74,74,74,74,74,54,20
153,179,-40,29,492,-328,750,-328,-141,-328,0,-10,-10,-7,31,30,30,-17,-17,-17,-7
-131,242,27,159,335,-172,686,-172,15,-172,-11,-20,-31,-51,-51,-51,-51,-49,-47,-36,-16
-90,108,-388,101,-64,-571,249,-571,-161,-571,30,0,30,68,-20,-50,75,52,30,0,0
-106,281,-112,147,43,-453,43,-636,-226,-636,-13,-5,-18,252,146,230,55,48,35,48,53
15,174,-117,-1,154,-580,154,-763,-353,-763,-64,105,41,230,-42,-28,208,88,50,114,9
-133,-24,-227,-120,21,-733,21,-733,-506,-916,3,-1,2,-24,-24,-24,42,-24,-24,-27,-26
-33,122,-85,83,-37,-450,-37,-791,-564,-974,-49,0,-49,-63,-48,-73,-78,-53,-52,-3,-3
8,429,188,252,406,-44,406,-507,-280,-690,-4,-45,-49,-119,-119,-119,-88,-19,-18,-14,31
-142,109,-137,-129,473,43,473,-122,-236,-646,6,-16,-10,125,175,175,65,25,-28,-34,-18
-60,-110,-367,-213,137,-473,137,-473,-572,-982,37,-50,-13,109,69,88,39,9,26,-11,39
90,-217,-320,-174,-184,-794,-184,-794,-889,-1120,2,4,6,61,61,34,32,21,18,16,12
-86,195,17,55,-30,-607,3,-607,-702,-933,13,22,35,8,183,374,182,97,55,42,20
-68,215,-43,144,244,-452,244,-558,-388,-884,-3,12,9,-84,-86,-82,-26,-24,4,7,-5
37,-209,-484,-444,-26,-354,-26,-828,-582,-828,4,20,24,307,79,59,64,40,38,34,14
21,7,-290,-138,9,-449,9,-687,-547,-793,47,-26,21,85,69,79,48,15,15,-32,-6
-86,-172,-360,-220,-274,-730,-272,-730,-828,-1074,45,21,66,-256,88,66,61,18,43,-2,-23
53,90,-67,-3,-177,-735,-177,-735,-833,-1079,11,5,16,-40,-3,-1,3,44,28,17,12
-1,561,253,254,644,-22,644,-181,-279,-525,0,-10,-10,-359,-413,-111,-51,-32,-43,-43,-33
47,-9,-181,-171,550,95,550,-275,-373,-619,43,-36,7,74,93,80,43,5,6,-37,-1
-45,160,-14,49,635,-96,635,-96,-171,-428,-85,-44,-129,-222,128,128,0,-222,-156,-71,-27
-69,479,201,301,774,126,857,126,265,32,-49,10,-39,-77,-77,-50,-47,-45,-27,22,12
102,-41,-186,-87,311,-42,689,-42,130,-136,32,25,57,-88,-88,162,52,74,63,31,6
23,195,-130,-122,526,29,821,29,174,29,25,-26,-1,127,175,97,-4,21,-4,-29,-3
-98,121,-94,1,627,-29,627,-29,275,-29,-52,-29,-81,98,98,98,98,-202,-113,-61,-32
147,106,-346,81,-54,-444,277,-444,-229,-444,-38,-21,-59,-14,-59,-52,-52,-52,-52,-14,7
-69,249,-24,134,218,-332,389,-332,-117,-332,0,-35,-35,-35,-98,-72,59,-35,-35,-35,0
-31,236,29,89,288,-293,288,-293,-78,-293,-10,0,-10,-51,-51,274,-19,-19,-11,-1,-1
-8,122,-99,-96,251,-232,251,-330,-115,-330,-16,-22,-38,152,142,121,-111,-111,-53,-37,-15
183,-144,-267,140,179,-171,179,-402,-187,-402,-65,-2,-67,187,30,-8,-2,-10,-35,30,32
72,442,113,157,534,140,586,103,220,5,-28,-1,-29,-1,95,-39,-3,-2,-31,-3,-2
-100,155,-51,10,553,209,682,209,316,101,-45,-10,-55,0,-202,-107,-76,-73,-57,-12,-2
24,-57,-235,-156,280,-309,372,-309,-103,-309,23,33,56,60,69,60,60,60,55,32,-1
-160,-371,-516,-379,-144,-733,-129,-733,-527,-733,-3,13,10,-120,-89,-163,-78,-9,5,8,-5
-62,174,-87,147,-426,-788,-199,-788,-582,-788,20,30,50,131,214,156,106,91,56,36,6
-26,-47,-328,-119,-130,-1018,-130,-1092,-886,-1092,19,23,42,252,152,145,119,67,40,21,-2
-2,32,-116,-47,-112,-940,-112,-1157,-951,-1157,0,22,22,87,87,77,38,32,27,27,5
-57,-55,-351,-96,-228,-716,-228,-1343,-1211,-1417,0,12,12,-11,228,126,77,26,-11,-11,-23
-123,123,-78,71,-67,-665,-67,-1212,-1223,-1429,0,10,10,8,-35,268,115,45,23,23,13
109,-96,-465,-130,-304,-815,-304,-1155,-1650,-1856,41,-41,0,-62,-46,-106,-101,-12,9,-32,9
-146,18,-289,-196,-45,-739,-45,-1041,-1599,-1805,9,19,28,-11,-6,54,41,28,28,19,0
-27,163,-301,4,-255,-727,-255,-1037,-1872,-2078,37,42,79,366,449,410,255,156,95,58,16
20,-334,-659,-368,-366,-1216,-366,-1541,-2355,-2533,-5,-25,-30,-363,37,-63,-63,-63,-68,-63,-38
61,280,-122,-85,-243,-1000,-243,-1165,-2154,-2299,0,26,26,-23,28,42,42,42,42,42,16
38,213,30,94,455,-564,455,-950,-1379,-1640,3,0,3,28,8,57,-9,30,11,8,8
38,-274,-492,-281,135,-713,135,-1145,-1616,-1897,16,39,55,0,0,0,109,83,58,42,3
71,116,-108,45,183,-444,183,-836,-1424,-1572,39,57,96,1,84,84,101,84,83,44,-13
-52,40,-222,17,15,-545,82,-766,-1352,-1648,1,10,11,100,15,14,5,22,15,14,4
58,7,-232,-78,-18,-603,24,-603,-1220,-1421,62,21,83,-158,47,9,12,45,71,9,-12
103,82,-169,-66,156,-131,156,-454,-863,-1232,-38,-4,-42,63,63,-110,-72,-56,-41,-3,1
-120,-69,-460,-426,72,-253,72,-538,-884,-1191,56,-7,49,4,21,-31,0,63,62,6,13
25,-491,-658,-167,-322,-854,-322,-854,-860,-1324,12,10,22,18,-57,22,-8,22,22,10,0
143,41,-373,-369,-378,-836,-304,-836,-810,-1135,23,24,47,293,444,347,161,-43,47,24,0
-118,-190,-518,-410,-110,-987,-110,-987,-847,-1065,0,-22,-22,-32,2,-40,-90,-70,-40,-40,-18
71,179,-29,91,-85,-766,-85,-962,-822,-1040,55,27,82,135,137,177,135,91,77,22,-5
3,274,78,179,432,-246,432,-709,-569,-787,-41,-8,-49,68,43,-500,-100,-70,-43,-2,6
-27,515,239,240,879,207,879,-66,101,-262,-13,0,-13,-65,102,35,10,0,-13,0,0
-54,-70,-319,-85,577,-63,577,-101,-201,-564,20,12,32,-31,58,47,58,46,33,13,1
-148,698,407,652,993,255,1151,255,373,10,-141,-40,-181,0,0,0,0,0,-181,-40,0
-11,-69,-275,-268,477,-55,841,-55,63,-300,-10,-31,-41,-53,-183,-137,-46,-43,-43,-33,-2
-49,202,-41,60,507,-156,802,-156,50,-181,-60,5,-55,-158,-158,-84,-42,-83,-74,-14,-19
22,125,-137,-110,514,-149,603,-149,57,-149,29,6,35,201,148,33,33,33,33,4,-2
124,179,-17,160,306,-52,611,-52,154,-52,-75,5,-70,0,0,-280,-268,-97,-72,3,-2
-9,737,246,250,966,620,1271,608,814,608,11,-8,3,63,65,4,4,-8,-8,-19,-11
-96,86,-127,38,799,163,883,163,654,163,-16,-30,-46,0,0,-180,-127,-67,-48,-32,-2
-18,188,29,159,782,-101,909,-101,112,-101,-15,1,-14,-18,-63,-97,-74,-17,-17,-2,-3
-72,125,-9,13,742,-39,887,-39,174,-39,-25,-3,-28,45,-41,-433,-41,-41,-40,-15,-12
21,-249,-557,-271,-334,-623,260,-623,-459,-623,9,2,11,-187,63,-27,2,0,10,1,-1
-35,-4,-150,-75,-298,-642,109,-672,-508,-672,16,-18,-2,10,10,10,10,10,8,-8,10
95,-14,-268,-145,-140,-778,-140,-808,-644,-808,22,70,92,166,166,164,136,123,91,69,-1
51,93,-118,-101,98,-630,98,-666,-532,-696,-8,-12,-20,78,-31,-1,-12,-12,-22,-14,-2
-93,456,136,206,536,264,536,-228,-94,-258,-104,0,-104,0,114,80,-51,-194,-132,-28,-28
171,-165,-338,-1,169,-231,169,-559,-461,-625,49,0,49,83,83,83,83,73,49,0,0
23,661,114,211,825,323,830,323,200,36,-62,14,-48,-118,-118,-299,-203,-117,-77,-15,-29
-33,170,5,32,877,241,957,241,327,163,-25,-13,-38,26,4,4,-25,-25,-38,-13,0
-90,88,-77,19,770,-13,934,-13,152,-13,-21,-9,-30,-111,-91,-70,-59,-56,-29,-8,1
-30,200,-92,-74,809,-38,898,-38,127,-38,52,-33,19,-63,-142,-124,-58,-44,8,-44,-11
89,-40,-198,-163,50,-242,659,-242,-23,-242,0,-20,-20,0,-62,-62,-82,-41,-31,-31,-11
7,58,-290,35,-140,-432,469,-432,-230,-432,-47,14,-33,116,35,-52,-32,-32,-32,15,1
-16,-58,-244,-134,-118,-608,-118,-608,-406,-608,-69,17,-52,88,92,37,-52,-41,-52,17,0
-294,93,-132,-64,-19,-525,-19,-569,-367,-569,-18,-13,-31,-142,-43,-43,-43,-3,-35,-17,-4
22,34,-373,-16,-223,-743,-223,-885,-683,-885,29,10,39,277,225,77,15,66,44,15,5
-105,223,56,202,251,-304,251,-624,-466,-668,-13,-7,-20,-168,-150,-168,-38,-38,-25,-12,-5
313,47,-150,-7,99,-383,99,-678,-618,-820,-18,28,10,-21,99,380,99,45,30,48,20
-63,338,-67,-50,457,50,457,-98,-260,-462,-31,-60,-91,32,-50,-338,-195,-42,-91,-60,0
59,308,-25,209,409,-87,437,-87,-280,-482,-17,-11,-28,-82,-339,-232,-71,-26,-32,-15,-4
119,135,-115,-61,472,0,524,0,-193,-395,-19,-35,-54,-55,-62,-58,-55,-55,-54,-35,0
-149,-208,-391,-386,184,-336,275,-336,-414,-572,1,-9,-8,178,159,7,23,4,-16,-17,-8
15,-287,-610,-320,-442,-1007,-365,-1007,-824,-1090,-14,18,4,7,446,-9,-12,12,12,26,8
26,171,-107,-30,-135,-855,-135,-855,-672,-855,51,19,70,45,171,165,90,70,70,19,0
18,434,260,311,551,-475,551,-475,-292,-475,31,-31,0,-50,-50,-50,-50,-1,0,-31,0
59,314,93,191,787,158,787,-239,-56,-239,-52,-16,-68,-164,-152,-64,-152,-107,-66,-14,2
136,97,-27,54,903,209,903,-123,60,-123,-57,-35,-92,54,51,-98,-98,-95,-98,-41,-6
105,93,-207,-101,847,34,964,34,121,-62,-12,-2,-14,-102,-87,-62,-97,-75,-21,-9,-7
-94,185,-102,-14,656,-42,1129,-42,258,-42,-9,-31,-40,0,0,0,-10,-44,-44,-35,-4
44,-111,-289,-121,45,-380,734,-380,-93,-380,-47,-93,-140,0,428,266,100,95,-95,-48,45
47,664,381,390,525,165,923,165,434,165,-42,43,1,271,245,148,195,68,45,87,44
24,80,-64,64,642,143,642,143,412,143,-100,0,-100,-19,76,76,-165,-227,-107,-7,-7
-41,180,42,119,751,45,751,45,189,45,-14,-16,-30,0,0,0,-284,-106,-48,-34,-18
75,218,-34,113,782,73,782,73,211,73,-38,38,0,0,0,-87,-37,33,-5,33,-5
4,91,-85,2,251,-3,813,-3,242,-3,-1,1,0,-56,-56,-79,-61,-37,-1,0,-1
-137,225,41,85,304,-30,868,-30,146,-30,-89,-30,-119,-301,-251,-192,-161,-149,-120,-31,-1
41,176,-20,140,230,-104,232,-104,72,-104,-53,0,-53,74,55,-61,-75,-75,-73,-20,-20
-48,24,-207,-147,105,-175,159,-175,1,-175,42,-40,2,-56,-36,40,40,24,2,-40,0
-55,139,-4,63,141,-171,195,-171,37,-171,-79,-27,-106,-216,-259,-220,-159,-140,-100,-21,6
56,126,-149,106,29,-283,29,-283,-75,-283,-19,23,4,2,2,2,-58,-42,12,31,8
-128,69,-85,-27,186,-223,186,-223,-15,-223,5,0,5,-100,-134,-27,-28,-2,18,13,13
-54,277,25,74,257,-18,257,-152,56,-152,-4,14,10,-141,-100,-43,12,9,10,14,0
-108,75,-145,-110,143,-152,143,-286,-78,-286,-6,-36,-42,-354,-155,-100,-75,-32,-32,-26,10
130,140,-36,121,97,-194,97,-198,-124,-332,-36,11,-25,15,120,-76,-38,-22,-21,15,4
-81,-27,-237,-212,74,-257,74,-264,-190,-398,-2,-15,-17,98,13,12,13,-4,-20,-18,-3
-174,175,46,120,144,-187,144,-190,-97,-328,1,-1,0,-305,-253,-145,-113,32,7,6,7
45,-5,-267,-90,-65,-407,-65,-427,-337,-568,6,36,42,-12,-12,15,5,3,37,31,-5
-54,44,-83,-29,14,-388,14,-408,-318,-549,50,0,50,42,42,42,42,59,47,-3,-3
-93,-200,-303,-123,-165,-457,-165,-597,-466,-624,67,-61,6,103,153,353,0,3,-14,-81,-20
51,-7,-237,-5,-305,-597,-305,-737,-606,-764,38,38,76,225,215,225,179,125,113,75,37
64,-55,-195,-103,-154,-590,-154,-744,-753,-907,-39,37,-2,121,116,53,34,6,-14,25,-12
42,170,-131,-18,81,-454,81,-608,-548,-768,20,0,20,0,295,116,59,58,36,16,16
-94,-112,-283,-128,-41,-459,-41,-665,-759,-979,15,13,28,90,291,191,92,41,36,21,8
18,69,-185,18,-147,-448,-147,-771,-855,-1065,15,18,33,0,0,197,133,39,34,19,1
-16,494,329,366,503,-14,503,-131,-421,-631,-44,-10,-54,59,21,-59,-26,-26,-59,-15,-5
-10,517,60,72,924,466,924,407,132,-70,6,-18,-12,-5,-5,-5,2,18,1,-5,13
-58,20,-148,-21,784,-80,784,-80,47,-210,-23,-11,-34,-300,-76,-139,-49,-49,-44,-21,-10
25,391,131,201,1034,111,1043,111,279,111,-38,2,-36,-29,-141,0,-191,-29,-66,-28,-30
59,45,-81,6,640,115,1047,115,283,115,4,7,11,-82,-82,-27,-27,6,6,2,-5
69,480,341,478,852,376,1495,376,502,376,-27,27,0,-19,-19,20,20,20,20,47,20
27,242,44,77,1055,544,1300,544,683,544,-44,-33,-77,0,-447,-356,-207,-130,-99,-55,-22
26,71,-47,-11,685,24,1035,24,222,24,-49,-23,-72,-87,0,0,-196,-87,-83,-34,-11
34,52,-93,24,617,-93,989,-93,25,-93,-63,5,-58,-123,-109,-103,-97,-14,-80,-17,-22
-18,191,-93,-41,362,93,825,93,211,93,-30,-16,-46,-93,-81,-81,-81,-62,-72,-42,-26
3,161,-124,115,145,-186,710,-186,98,-186,0,19,19,40,40,40,-140,-48,-9,-9,-28
-49,-52,-203,-67,59,-288,167,-288,-4,-288,-18,-14,-32,-52,-132,-67,-52,-35,-33,-15,-1
-26,248,-58,18,167,-180,167,-180,56,-180,-36,-13,-49,39,-3,-44,-44,-44,-43,-7,6
25,-143,-264,-203,31,-335,31,-397,-161,-397,0,50,50,339,239,206,139,39,39,39,-11
229,-76,-167,-113,-81,-424,-81,-509,-273,-509,49,41,90,-41,57,316,160,57,57,8,-33
-2,354,55,-29,277,-34,277,-94,80,-156,-13,-45,-58,-30,-35,-103,-80,-30,-60,-47,-2
89,193,-13,-1,448,71,448,23,174,-62,15,4,19,-164,-66,-164,-50,-6,1,-14,-18
-62,124,-131,9,458,-3,458,-3,184,-52,-3,-51,-54,-51,-91,-53,6,-106,-59,-56,-5
-3,96,-26,33,478,-111,478,-111,144,-111,0,28,28,204,179,333,204,51,39,39,11
-89,108,-39,18,308,-26,563,-26,181,-26,-6,-11,-17,-61,-31,-27,-27,-27,-17,-11,0
159,138,-89,123,145,-123,479,-123,24,-123,16,-37,-21,-433,0,0,-428,-52,-25,-41,-4
33,-125,-345,-191,-16,-277,70,-277,-130,-277,-31,-29,-60,71,56,56,-168,-60,-60,-29,0
107,31,-188,-178,-31,-360,-24,-360,-145,-360,19,-10,9,136,136,124,52,36,35,16,26
182,206,-64,-33,226,-165,226,-165,50,-165,-7,-21,-28,-149,-37,-98,-69,-14,-28,-21,0
-5,179,-112,16,407,16,407,16,231,16,-9,-31,-40,61,49,47,-123,-51,-55,-46,-15
-45,165,44,98,499,-20,499,-20,271,-20,0,0,0,110,94,26,20,20,20,20,20
-26,301,101,195,667,168,687,168,353,168,-5,-6,-11,-98,-63,-63,-48,-42,-13,-8,-2
17,168,69,107,567,209,795,209,409,209,-2,-47,-49,25,-335,-159,-159,-100,-49,-47,0
-2,89,-48,0,506,114,820,114,213,114,-18,-18,-36,-155,-114,-114,-103,-55,-39,-21,-3
133,-90,-165,-158,309,-193,467,-193,-56,-193,42,-14,28,294,329,269,195,80,30,-12,2
113,188,-144,-136,213,-48,506,-48,55,-48,5,8,13,-37,-25,-28,-5,7,10,5,-3
41,218,-93,-22,381,49,647,49,248,49,-5,-99,-104,40,40,40,-98,-87,-92,-87,12
-54,79,-34,-26,463,-11,488,-11,300,-11,-37,9,-28,36,36,-48,-28,-22,-17,20,11
4,2,-328,-12,161,-336,161,-336,-223,-336,0,64,64,9,9,10,37,60,68,68,4
13,75,-85,-45,-16,-354,143,-354,-241,-354,136,79,215,0,0,0,0,394,235,99,20
34,127,-83,74,120,-309,188,-309,-196,-309,0,-2,-2,20,20,20,5,-5,-5,-5,-3
13,99,-85,-74,182,-246,182,-254,-141,-254,-38,-15,-53,-102,-102,-102,-75,-70,-53,-15,0
46,561,165,179,619,352,619,183,296,183,-17,-26,-43,-38,-38,-38,-13,-38,-55,-38,-12
2,85,-72,-15,676,222,676,222,353,222,6,44,50,34,34,55,49,50,50,44,0
-15,-12,-170,-50,524,-166,582,-166,-9,-166,16,46,62,-39,-39,-39,15,19,14,-2,-48
-74,142,-42,45,524,-170,582,-170,-12,-170,-5,-32,-37,-78,-78,-40,-40,-40,-40,-35,-3
22,-56,-388,-365,-98,-410,284,-410,-252,-410,21,-31,-10,0,0,10,38,2,0,-21,10
-67,-45,-391,-70,-336,-690,4,-690,-532,-690,43,-3,40,110,110,80,33,33,33,-10,-7
75,35,-169,16,-195,-818,-195,-840,-682,-840,-14,-1,-15,0,0,0,0,0,1,15,16
-111,34,-110,-54,55,-798,55,-820,-662,-820,-8,22,14,42,42,-54,30,30,14,22,0
44,109,-134,75,-44,-620,-44,-897,-761,-919,-32,-20,-52,-137,-137,-97,-49,-44,-61,-29,-9
40,-5,-243,-220,58,-299,58,-948,-812,-970,-1,0,-1,156,156,156,150,70,-1,0,0
-68,108,-101,29,56,-262,56,-673,-814,-972,20,46,66,29,29,9,73,67,50,30,-16
54,114,-30,66,100,-253,100,-309,-822,-980,0,0,0,-10,-10,-10,0,44,0,0,0
-13,373,178,260,424,57,424,40,-512,-670,3,-45,-42,-88,-88,-113,50,10,-20,-23,22
51,147,-133,89,281,35,281,-86,-501,-791,-36,-44,-80,-144,-144,-55,-83,-55,-73,-37,7
-15,427,77,111,565,151,565,151,-175,-507,4,78,82,11,11,-37,36,25,45,41,-37
27,272,5,70,684,247,735,247,286,-60,-15,-30,-45,67,67,0,-8,-3,-49,-34,-4
-114,304,87,117,841,245,975,245,512,245,-50,-53,-103,-148,-148,-148,-148,-149,-137,-87,-34
-40,217,-3,172,841,91,928,91,308,91,75,2,77,86,86,86,14,172,167,92,90
-32,-37,-264,-49,234,-285,563,-285,-65,-285,105,0,105,-12,-12,107,41,35,93,-12,-12
-1,287,142,182,153,-158,686,-158,62,-158,-50,20,-30,-238,-238,-122,-100,-70,-30,20,0
111,180,33,0,360,-85,434,-85,135,-85,4,15,19,62,62,62,-69,-6,4,0,-15
112,146,-62,55,465,41,465,20,240,20,-11,-22,-33,94,94,94,-52,-42,-33,-22,0
72,-39,-544,-57,53,-474,53,-474,-266,-474,-12,10,-2,0,0,403,161,4,4,16,6
98,199,7,117,154,-351,246,-351,-73,-351,-45,8,-37,-71,-71,-69,-41,-76,-46,-1,-9
22,484,-69,-64,616,66,663,66,344,66,-16,-10,-26,26,26,-33,-26,-26,-26,-10,0
-3,137,-23,117,697,12,697,12,425,12,0,-40,-40,-81,-81,57,-43,-73,-43,-43,-3
-45,163,-23,121,733,13,733,13,173,13,0,-15,-15,-41,-41,-44,-52,-32,-27,-27,-12
-53,102,-90,73,538,-86,670,-86,100,-86,23,36,59,44,44,53,67,55,53,30,-6
63,130,-57,74,150,-50,710,-50,140,-50,0,4,4,106,106,86,-31,12,10,10,6
41,139,-15,3,292,93,728,93,280,93,0,4,4,2,2,3,-15,0,0,0,-4
153,15,-167,-34,192,-115,200,-115,39,-115,0,0,0,2,2,24,25,0,0,0,0
-5,183,-103,-64,335,-12,347,-12,170,-12,0,0,0,58,58,4,59,37,4,4,4
-40,193,10,151,245,-52,398,-52,221,-52,-9,-29,-38,-87,-87,-52,-52,-52,-54,-45,-16
-57,177,15,133,248,-38,400,-38,207,-38,-28,-40,-68,-149,-149,-255,-134,-100,-78,-50,-10
27,-24,-180,-87,136,-150,147,-150,65,-150,24,28,52,53,53,53,53,47,52,28,0
-94,159,-30,7,206,-69,247,-69,87,-69,27,53,80,-106,-106,-46,21,84,69,42,-11
110,-4,-210,-56,-54,-299,17,-299,-143,-299,28,3,31,55,55,21,21,54,40,12,9
3,283,138,167,310,15,310,15,171,15,-105,-56,-161,73,73,77,65,0,-152,-47,9
3,282,137,56,309,53,309,14,170,14,17,-11,6,0,11,12,11,39,19,2,13
187,186,28,154,435,229,435,140,296,140,52,-11,41,0,107,48,6,48,47,-5,6
-40,662,567,113,899,519,926,519,677,519,-2,-24,-26,0,-61,5,-11,19,-21,-19,5
-58,880,639,-69,940,560,967,560,703,560,2,11,13,-463,-19,-19,17,14,14,12,1
-4,464,-6,16,816,496,876,496,639,496,5,11,16,0,16,16,16,16,16,11,0
-100,75,-121,0,829,7,889,7,477,7,5,6,11,0,17,17,-89,54,36,31,25
13,11,-164,59,711,-239,711,-239,-43,-239,14,6,20,0,-7,-46,-7,7,21,7,1
2,34,-98,57,435,-163,787,-163,33,-163,0,0,0,0,10,57,11,10,10,10,10
-49,403,176,165,305,55,1005,55,251,55,-10,-9,-19,-338,-95,-83,-45,-20,-25,-15,-6
28,105,8,-32,171,-112,421,-177,19,-177,16,17,33,0,0,-31,48,40,33,17,0
118,209,-149,-17,264,-19,264,-84,112,-84,26,10,36,-477,-17,-17,55,54,32,6,-4
-143,176,-84,34,313,-100,313,-100,161,-100,0,-2,-2,-428,-123,-65,-34,-5,-2,-2,0
99,72,-118,-10,193,-165,248,-165,96,-165,19,38,57,-493,70,203,135,68,70,51,13
63,202,-53,164,353,-5,408,-5,232,-5,-15,6,-9,-333,40,10,10,0,1,16,10
82,300,75,-91,246,-78,328,-78,177,-78,-10,-34,-44,-358,0,485,235,-14,-25,-15,19
-122,438,120,54,460,82,488,82,337,82,-11,0,-11,-198,-55,-55,-9,-13,-16,-5,-5
-14,218,62,1,488,110,488,110,365,110,9,31,40,-170,-77,-26,0,50,40,31,0
59,17,-142,-116,317,-109,317,-109,47,-109,-3,6,3,-341,-48,-48,-76,-36,-21,-18,-24
-24,150,-50,40,440,3,462,3,162,3,-12,13,1,-196,42,-26,-10,0,-5,7,-6
101,139,-61,62,204,-38,474,-38,162,-38,2,-19,-17,-184,-91,-71,-61,-37,-19,-21,-2
29,115,-73,-43,142,-93,420,-93,107,-93,2,7,9,-216,-23,-3,12,7,16,14,7
101,147,-36,-9,162,-61,204,-61,139,-61,2,-19,-17,-184,-91,-71,-61,-37,-19,-21,-2
29,-3,-135,-43,115,-93,142,-93,107,-93,2,7,9,-216,-23,-3,12,7,16,14,7
162,217,84,132,288,38,303,38,170,38,0,20,20,0,-20,-20,-20,0,0,0,-20
-42,19,-210,-14,278,28,278,28,160,28,-18,-34,-52,0,-7,-3,-3,-3,-48,-30,4
-133,47,-66,-26,167,-250,238,-250,-21,-250,13,-3,10,0,-67,-25,-32,-5,12,-1,2
58,329,114,141,314,-103,385,-103,126,-103,-2,-2,-4,0,67,-72,-4,-4,-4,-2,0
-2,-287,-652,-305,-235,-667,-235,-667,-438,-667,23,30,53,0,88,121,106,28,66,43,13
12,152,-215,148,-335,-752,-335,-767,-538,-767,11,13,24,0,9,9,68,63,33,22,9
-116,98,-84,53,218,-686,218,-701,-472,-701,5,15,20,0,17,15,-34,28,20,15,0
70,20,-124,-21,99,-805,99,-805,-591,-820,7,15,22,0,-33,13,8,8,9,2,-13
-69,344,160,218,379,12,379,-525,-311,-540,-20,-26,-46,-96,-68,-34,-50,-38,-34,-14,12
9,90,-94,-24,273,6,308,-596,-382,-611,-16,-16,-32,-24,-24,-24,-24,-24,-40,-24,-8
-108,194,7,36,343,-24,378,-24,-312,-541,-5,-29,-34,-4,-35,-79,-96,-39,-35,-30,-1
-9,99,-81,66,283,-84,283,-84,-372,-601,11,62,73,-95,-31,59,65,18,58,47,-15
-67,159,-165,122,18,-200,167,-200,-420,-702,26,-44,-18,-17,-17,-45,-33,-17,-15,-41,3
-100,-104,-275,-191,-94,-450,-86,-453,-590,-955,6,22,28,9,-170,-69,29,30,25,19,-3
-66,-47,-317,-105,-371,-727,-371,-730,-867,-1232,40,-5,35,0,103,68,53,52,43,3,8
43,88,-116,-30,-76,-724,-76,-756,-576,-759,0,-30,-30,-56,-56,-30,-29,-30,-30,-30,0
115,-177,-282,-281,-66,-735,-66,-910,-730,-913,25,18,43,-30,0,0,-11,-11,45,20,2
39,10,-240,-43,-119,-553,-119,-931,-783,-966,-90,-15,-105,337,49,6,-1,-7,-99,-9,6
-101,394,177,294,251,-94,251,-547,-542,-725,-3,-3,-6,95,43,20,-42,2,0,3,6
-46,289,-72,-43,565,77,565,-141,-371,-554,0,2,2,-43,-43,-20,0,-6,-5,-5,-7
-137,6,-107,-37,452,-185,452,-185,-484,-664,34,-36,-2,4,27,-4,16,-36,-36,-70,-34
21,168,-347,68,172,-465,172,-465,-764,-944,56,0,56,86,236,236,168,71,62,6,6
-39,249,70,245,296,-337,300,-337,-470,-784,-22,-15,-37,-4,-58,-4,-35,-13,-36,-14,1
25,38,-133,-40,232,-323,236,-401,-534,-705,5,-22,-17,71,27,-70,0,0,0,-5,17
187,216,-13,64,382,-133,382,-251,-60,-320,0,-13,-13,63,58,10,-13,-1,-1,-1,12
43,420,-68,23,710,362,757,202,315,124,-21,-51,-72,-67,-67,-73,-75,-64,-73,-52,-1
62,85,-124,38,560,-99,726,-99,284,-99,4,-45,-41,249,194,39,-27,-25,-12,-16,29
-51,43,-407,42,300,-384,419,-384,-175,-384,18,12,30,-45,-46,-46,79,20,34,16,4
-83,8,-468,-36,-294,-830,-123,-830,-598,-830,-5,-48,-53,-57,-122,-89,-35,-97,-42,-37,11
-97,385,7,94,207,-631,207,-631,-399,-631,-51,-10,-61,161,10,-6,-38,-29,-51,0,10
-70,-140,-570,-187,-75,-1091,-75,-1091,-859,-1091,-19,-21,-40,-111,-50,-111,-84,-50,-40,-21,0
6,194,-30,60,-109,-763,-109,-1125,-893,-1125,0,0,0,73,35,35,15,15,15,15,15
116,0,-231,-24,15,-783,15,-1304,-1072,-1304,27,9,36,51,37,12,51,30,37,10,1
177,238,-164,111,243,-555,243,-714,-844,-1076,6,-16,-10,139,148,139,94,15,5,-1,15
40,-20,-252,-122,218,-189,218,-580,-869,-1101,23,12,35,-56,-14,0,0,22,30,7,-5
-118,326,107,227,440,-25,445,-353,-642,-874,50,8,58,72,52,63,-112,35,30,-20,-28
-23,-46,-238,-103,231,-234,236,-234,-851,-1083,0,-7,-7,-45,-112,64,18,8,8,8,15
140,282,-16,84,326,-29,440,-29,-424,-874,-13,-2,-15,-13,-13,-77,-77,-13,-13,0,2
-205,85,-141,-46,374,19,488,19,12,-464,-10,-15,-25,-35,-46,-45,-169,-83,-71,-61,-46
339,-59,-346,-250,-19,-490,25,-490,-264,-654,38,39,77,285,286,285,282,113,83,45,6
-35,379,4,179,391,-80,435,-80,146,-244,-37,-71,-108,0,0,0,0,-148,-123,-86,-15
-320,-39,-273,-105,144,-315,156,-315,-89,-315,0,-8,-8,-36,-36,-36,-154,-36,-36,-36,-28
18,4,-601,-12,-453,-870,-441,-912,-686,-912,-4,18,14,159,188,141,84,54,47,51,33
191,114,-61,62,61,-813,61,-855,-629,-855,2,-20,-18,46,45,45,-17,-1,-17,-19,1
80,134,-124,5,246,-681,246,-681,-497,-723,-3,-2,-5,5,5,5,5,1,0,3,5
50,341,150,202,581,-77,581,-346,-162,-388,-36,-61,-97,126,49,68,-28,-54,-54,-18,43
-43,169,-64,51,599,168,599,-328,-144,-370,5,20,25,-451,-280,-207,-54,13,50,45,25
-133,-22,-198,-102,319,-232,431,-232,-312,-538,16,-10,6,-171,-171,-171,0,52,-12,-28,-18
-44,-180,-541,-250,-307,-730,-67,-730,-810,-1036,66,0,66,306,132,155,120,120,66,0,0
-58,296,-75,83,50,-500,51,-500,-530,-764,27,-2,25,110,116,128,95,67,40,13,15
65,-127,-401,-133,-76,-838,-76,-872,-902,-1136,13,-3,10,-72,-45,-102,-66,-32,11,-2,1
150,144,-163,-75,-4,-611,-4,-800,-830,-1064,23,21,44,150,120,87,-4,68,70,47,26
41,495,-88,-54,644,125,644,-266,-90,-300,59,26,85,-22,33,42,70,5,105,46,20
-163,86,-126,5,720,-12,720,-35,-14,-224,-7,29,22,46,46,4,4,46,27,34,5
-82,384,-1,311,798,-48,798,-48,64,-146,-49,0,-49,24,-2,-23,23,-62,-49,0,0
129,183,-75,-8,673,-24,822,-24,88,-122,45,-36,9,208,-8,10,3,39,37,-8,28
197,254,-118,-30,670,187,1084,187,350,140,43,0,43,10,70,163,90,42,38,-5,-5
-4,152,-89,54,790,2,1055,2,374,2,-6,0,-6,-6,-6,-6,-6,-6,-6,0,0
87,218,57,90,655,1,880,1,242,1,-1,-6,-7,45,45,32,21,6,-1,0,6
-116,38,-174,-3,465,2,881,2,219,2,-26,0,-26,-73,-32,-32,-32,-3,-29,-3,-3
49,283,96,106,342,-75,755,-75,137,-75,27,-9,18,71,71,71,64,42,27,0,9
-74,325,77,323,488,95,734,95,307,95,3,0,3,-39,-38,-20,-29,-20,-17,-20,-20
-24,72,-115,33,377,1,436,1,231,1,0,1,1,-17,-11,-16,-6,0,0,0,-1
10,343,133,166,660,168,695,168,355,168,18,15,33,120,71,62,65,53,47,29,14
-14,102,-32,86,585,186,713,186,396,186,-7,-4,-11,63,30,-33,-70,-33,-12,-5,-1
35,83,-106,-5,392,-48,697,-48,86,-48,-8,-19,-27,-48,-48,-48,-48,-48,-43,-35,-16
-122,113,-72,-48,416,-70,605,-70,119,-70,-20,5,-15,-20,-20,-20,-30,-20,-20,0,-5
21,158,-187,108,-40,-234,266,-234,-49,-234,-14,52,38,-92,-109,-72,-48,-91,11,25,-27
0,209,-92,138,163,-229,259,-229,-44,-229,-1,1,0,136,0,0,0,0,0,1,0
-95,112,-68,79,223,-215,223,-215,-30,-215,-60,-1,-61,-107,-87,-81,-78,-69,-60,0,1
188,315,60,165,354,-37,354,-84,101,-84,13,8,21,53,53,47,38,24,31,18,10
-3,171,-107,-42,545,244,545,107,292,107,-22,0,-22,-59,-58,-43,74,-14,-22,0,0
-79,-15,-129,-53,413,-200,452,-200,78,-200,0,0,0,0,0,0,0,0,0,0,0
-168,571,-10,-144,260,-353,299,-353,-168,-353,13,30,43,0,0,10,83,34,43,30,0
-20,245,-95,130,139,-785,139,-785,-600,-785,23,28,51,151,171,171,130,60,51,28,0
151,72,-227,-93,84,-875,84,-946,-761,-946,-28,0,-28,135,-72,75,-10,-10,-38,-10,-10
-57,92,-237,41,280,-407,280,-750,-565,-750,19,13,32,22,16,6,4,-20,37,18,5
-139,176,-188,-200,260,-257,260,-699,-585,-770,-42,-44,-86,-284,-334,-301,-271,-134,-113,-71,-27
127,206,-160,-43,-223,-728,-211,-898,-1056,-1241,9,21,30,-10,25,20,44,25,30,21,0
-126,212,-48,77,281,-653,281,-653,-981,-1166,37,40,77,46,253,254,220,100,77,40,0
248,0,-378,-213,-29,-894,-29,-963,-1291,-1476,12,15,27,0,453,360,222,61,27,15,0
0,100,-101,21,53,-342,53,-910,-1238,-1423,21,11,32,273,221,243,163,126,42,21,10
-32,254,-19,-75,7,-418,7,-934,-1331,-1445,0,-22,-22,-22,-22,-22,-30,-22,-22,-22,0
-23,168,-42,-126,34,-638,34,-655,-894,-1393,6,5,11,-8,5,18,0,2,11,5,0
-5,280,-58,0,38,-544,38,-768,-1024,-1353,43,15,58,67,67,67,112,73,58,15,0
-7,59,-170,9,72,-577,72,-976,-1232,-1561,53,0,53,162,163,162,126,98,62,9,9
48,236,-100,-50,54,-398,54,-770,-1250,-1579,16,-5,11,-15,-6,-3,10,11,11,-5,0
-378,414,15,-218,-163,-683,-163,-994,-1545,-1909,-1,0,-1,-99,-58,-6,15,15,-6,-5,-5
-24,134,-106,152,421,-580,421,-790,-1106,-1403,27,10,37,134,58,72,58,52,41,14,4
261,5,-397,5,347,-566,347,-750,-1180,-1460,0,-16,-16,199,206,204,175,78,-18,-18,-2
-21,116,-136,-79,521,-223,521,-480,-908,-1286,-36,-14,-50,-28,-40,-28,-40,-40,-48,-12,2
-120,319,-45,-5,337,-120,624,-289,-758,-959,-8,-73,-81,75,47,-73,-114,-46,-63,-55,18
-315,501,2,-169,-67,-506,238,-506,-897,-1170,17,22,39,66,100,67,119,69,38,21,-1
173,16,-448,-395,-378,-1310,-378,-1385,-1642,-1852,67,15,82,390,390,389,224,157,67,0,-15
-1,144,-224,-351,-24,-1350,-24,-1425,-1453,-1778,100,0,100,350,0,0,250,180,150,50,50
137,378,-208,-26,66,-995,66,-1428,-1531,-1760,-107,32,-75,-26,-99,-68,284,-98,-100,7,-25
103,7,-498,46,476,-468,476,-1330,-1238,-1574,0,2,2,12,-7,-57,-29,50,50,50,48
146,-3,-408,55,920,-54,920,-453,-622,-961,0,14,14,55,-15,-15,-36,-15,14,14,0
-37,113,-241,120,1171,-157,1171,-157,-371,-710,-3,-16,-19,-135,-24,-24,-119,-25,-5,-2,14
-5,135,-304,-11,855,-88,1324,-88,-218,-557,40,20,60,111,218,48,68,-11,78,38,18
-160,507,21,-43,272,-433,1195,-433,-347,-611,-71,-12,-83,52,14,14,-13,-88,-93,-22,-10
10,80,-184,180,268,-672,487,-672,-486,-850,-15,-14,-29,-420,-225,-138,-49,-50,-45,-30,-16
157,22,-242,213,542,-398,542,-398,41,-398,-22,-28,-50,43,24,24,-56,-11,-26,-4,24
-340,478,-62,-161,556,-228,556,-384,36,-384,-17,-16,-33,101,5,-11,-42,9,-28,-11,5
80,137,-115,158,490,-216,568,-372,48,-372,0,0,0,-200,-100,65,0,0,0,0,0
172,193,-286,15,611,-95,689,-95,169,-251,0,19,19,23,-49,291,101,6,21,21,2
135,-34,-448,208,905,8,905,8,463,8,53,-18,35,121,83,85,63,63,55,2,20
-114,328,0,116,1015,15,1368,15,429,15,-57,-15,-72,-472,-472,-465,-128,-162,-72,-15,0
-25,98,-130,60,691,-259,1109,-259,69,-259,0,27,27,-80,-59,-31,-11,44,12,12,-15
8,51,-172,-14,102,-327,688,-327,1,-327,24,-82,-58,124,106,101,-53,61,-11,-35,47
6,35,-204,-6,110,-268,682,-268,60,-268,17,-26,-9,161,50,60,-23,-23,-6,-23,3
-138,158,-58,77,252,-62,303,-126,177,-126,-22,-22,-44,-122,2,-98,12,7,-42,-20,2
-187,257,-24,34,246,-68,246,-132,152,-132,0,-24,-24,284,276,96,94,34,-3,-3,21
-175,259,-15,185,380,55,380,55,275,-9,-1,1,0,-4,4,41,19,-4,-4,-3,-4
321,30,-473,111,369,-26,369,-26,248,-26,0,0,0,-12,12,8,88,8,-8,-8,-8
23,36,-147,-46,709,-133,709,-133,370,-133,-8,-6,-14,-43,-27,-43,-11,20,-11,-3,3
11,22,-117,-117,588,-147,709,-147,36,-147,-1,0,-1,8,-132,-132,-52,-8,-8,-7,-7
0,70,-138,1,422,-95,761,-95,74,-95,0,-22,-22,1,1,22,1,-28,-40,-40,-18
-78,154,-47,-64,88,-138,640,-138,70,-138,-58,-5,-63,136,-14,0,-14,-25,-57,1,6
68,-40,-240,-86,14,-278,282,-278,-70,-278,8,8,16,12,0,-48,2,-13,18,10,2
167,167,-100,3,201,-91,201,-91,117,-91,10,43,53,117,77,83,48,47,57,47,4
-90,315,108,247,502,201,502,201,418,201,0,33,33,198,88,40,47,27,26,26,-7
-81,182,-8,144,512,152,546,152,359,152,58,20,78,-108,-133,-58,73,22,61,3,-17
-150,-172,-292,-210,209,-311,243,-311,-121,-311,10,-2,8,-11,64,74,46,-9,0,-10,-8
131,-125,-420,-208,-303,-670,-150,-670,-531,-670,1,-42,-41,330,120,130,141,-25,-22,-23,19
60,76,-248,47,-167,-712,-167,-712,-573,-712,-30,-20,-50,-26,-82,-87,-78,-17,-42,-12,8
20,89,-88,31,159,-610,159,-629,-490,-629,6,0,6,71,71,20,20,19,6,0,0
176,167,1,82,273,-265,273,-515,-376,-515,-26,5,-21,-2,-15,-20,45,-79,-16,10,5
-32,714,108,185,864,540,864,95,215,76,-146,83,-63,184,-44,39,-498,-174,-74,72,-11
89,183,-84,-82,885,199,955,199,306,167,0,16,16,16,4,0,16,16,16,16,0
-96,-16,-244,-116,817,-116,923,-116,151,-116,0,-1,-1,-38,-11,-11,-11,-11,-6,-6,-5
108,84,-294,-138,688,-329,768,-329,-101,-329,-55,21,-34,-30,-55,-68,-68,-20,-31,24,3
138,-13,-200,-87,66,-347,714,-347,-119,-347,2,-7,-5,-66,-22,-28,-18,-15,-16,-18,-11
-265,100,-510,75,-316,-729,288,-729,-501,-729,0,19,19,117,139,100,64,39,25,25,6
304,-94,-515,-271,-375,-1169,-375,-1204,-976,-1204,1,68,69,175,175,300,19,75,69,68,0
76,479,-21,37,360,-603,360,-750,-522,-750,-31,-77,-108,251,238,81,-36,-60,-100,-69,8
91,286,-59,186,549,-461,549,-645,-452,-680,-35,-50,-85,337,126,74,74,10,-86,-51,-1
8,83,-184,-76,484,-124,484,-598,-517,-745,-15,21,6,-95,34,-13,-9,-1,-1,14,-7
-97,-209,-480,-286,70,-598,70,-940,-931,-1159,3,45,48,-60,-60,-10,0,20,25,22,-23
24,100,-166,11,-313,-718,-50,-718,-1051,-1279,39,12,51,362,30,101,89,34,39,0,-12
6,107,-70,-40,220,-598,220,-598,-931,-1159,-33,-8,-41,-61,-80,-59,-40,-63,-39,-6,2
469,241,3,81,349,-351,349,-469,-696,-995,-10,1,-9,0,59,54,31,19,9,19,18
114,516,-26,10,866,520,866,48,-179,-366,1,-1,0,-72,-164,-128,-114,2,3,2,3
25,-16,-253,-160,747,-37,855,-37,304,-305,44,-44,0,-162,-145,-145,-95,-65,-21,-65,-21
58,427,105,167,1084,84,1192,84,321,84,-80,5,-75,59,-33,-189,-28,-43,-77,3,-2
63,190,-90,0,970,212,1212,212,449,212,0,-29,-29,0,-280,-91,-90,-30,-30,-30,-1
-11,247,88,114,741,96,1398,96,376,96,-29,-109,-138,-145,-145,-145,-145,-123,-123,-94,15
-71,282,53,208,900,247,1315,247,406,247,-10,1,-9,-7,-25,-22,-24,-7,4,14,13
-50,233,71,120,641,159,1006,159,388,159,-45,-24,-69,-93,-67,-114,-95,-76,-79,-34,-10
-4,132,-136,33,443,2,937,2,164,2,-36,-2,-38,-18,-86,-62,-79,-48,-48,-12,-10
-14,3,-147,-48,250,-205,503,-205,63,-205,14,11,25,32,18,3,3,8,17,3,-8
10,416,246,305,400,100,679,100,308,100,-17,-20,-37,-12,34,-37,-62,-37,-29,-12,8
-33,63,-67,-57,447,131,586,131,339,131,2,5,7,-44,-31,-31,-31,-16,-5,-7,-12
-135,166,27,123,492,-22,492,-22,108,-22,10,15,25,-78,-55,14,34,34,24,14,-1
1,473,269,368,746,232,746,232,362,232,0,25,25,68,67,28,30,28,18,18,-7
139,52,-68,-7,457,216,730,216,346,216,0,0,0,0,0,0,0,0,0,0,0
-37,208,-57,-58,203,-322,476,-322,-202,-322,-18,-8,-26,-57,-12,-30,-12,-12,-30,-12,-4
45,79,-52,41,144,-386,144,-386,-266,-386,7,43,50,13,13,41,41,41,41,34,-9
-60,87,-122,-34,42,-488,42,-488,-368,-488,60,50,110,-100,4,21,-6,72,92,32,-18
-38,118,-115,110,205,-105,205,-370,-250,-370,-42,22,-20,95,-169,-233,-181,-129,-42,0,-22
-94,146,-56,-296,-88,-408,-88,-663,-543,-663,-50,-53,-103,45,45,-86,-132,-93,-93,-43,10
76,46,-197,68,140,-414,140,-414,-549,-669,9,-36,-27,151,137,101,18,-1,-8,-17,19
104,-4,-196,83,247,-307,247,-307,-442,-562,18,4,22,109,109,41,41,22,22,4,0
46,19,-170,-190,179,-264,179,-375,-510,-630,15,32,47,388,274,105,-41,80,57,42,10
-257,336,31,98,292,-57,386,-168,-303,-423,-7,-9,-16,-133,-151,-91,-21,-21,-20,-13,-4
126,16,-348,-35,15,-378,65,-378,-624,-744,40,20,60,121,126,176,76,76,76,36,16
51,45,-67,-170,133,-231,133,-261,-162,-372,-34,-32,-66,-50,-50,-50,-37,-25,-46,-12,20
-6,349,-72,6,173,-191,173,-221,-122,-332,10,-26,-16,-156,-126,-49,-19,-19,-19,-29,-3
-19,132,-53,377,649,109,649,109,201,-32,9,50,59,-287,0,-412,-171,-66,-57,-66,-116
-133,234,0,255,806,104,806,104,289,104,-20,50,30,-239,-110,-110,-109,-6,20,40,-10
-190,258,-59,-4,654,-152,654,-152,82,-152,-9,31,22,18,-4,-5,-5,-4,-4,5,-26
-102,390,-50,120,250,-160,646,-160,74,-160,15,-29,-14,-50,-10,-3,19,-20,0,-15,14
3,107,-71,307,328,-222,584,-222,12,-222,-11,29,18,-287,-326,-157,-32,-30,-8,3,-26
6,127,-72,150,518,61,518,-32,202,-32,-9,80,71,-280,-142,150,88,89,69,78,-2
-52,67,-63,-86,375,-215,375,-215,-16,-215,2,-3,-1,65,-36,15,-16,-15,-8,-10,-7
45,514,-68,154,301,-68,522,-68,131,-68,9,-18,-9,-127,-68,17,10,-8,-17,-26,-8
-87,203,-19,-49,-7,-589,1,-589,-390,-589,-10,-78,-88,-59,-159,-159,-143,-79,-59,-49,29
25,100,-112,-84,-28,-820,-28,-820,-621,-820,3,-20,-17,-24,-49,-49,-63,-21,-29,-32,-12
23,23,-105,82,134,-786,134,-786,-587,-786,0,0,0,58,55,55,30,6,0,0,0
215,17,-261,-44,127,-223,127,-793,-594,-793,4,92,96,8,24,37,45,37,62,58,-34
35,48,-335,118,380,-8,380,-540,-341,-540,10,-2,8,-125,-32,22,22,0,-9,-19,-17
-2,72,-100,-109,463,-142,573,-142,-148,-347,40,-7,33,-14,-23,-83,7,8,26,-14,-7
54,59,-136,-23,499,-106,609,-106,-112,-311,-12,14,2,19,119,-129,-107,-23,-20,-8,-22
3,151,-82,54,366,-47,588,-47,-23,-222,-47,18,-29,-146,-91,38,-141,-72,-49,-2,-20
-320,377,-56,118,177,-102,568,-102,40,-242,-20,17,-3,-35,88,41,41,33,-7,13,-4
-60,139,-68,46,144,-335,144,-335,-105,-475,43,3,46,-95,-85,-69,-23,47,11,-32,-35
-195,282,-21,42,171,-308,171,-308,-78,-308,-17,-19,-36,-158,-158,-7,4,-20,-38,-21,-2
59,29,-111,-136,-121,-665,-121,-711,-481,-711,6,16,22,91,98,159,179,79,29,23,7
-79,89,-386,19,113,-360,113,-627,-397,-627,46,-69,-23,463,279,137,123,-3,-22,-68,1
68,185,-93,-17,361,-138,361,-333,-149,-379,31,-25,6,50,-17,3,37,11,6,-25,0
-184,356,9,-83,132,-367,132,-367,-378,-608,0,0,0,82,-16,-48,-19,-85,-18,-18,-18
-98,100,-69,76,159,-564,159,-564,-575,-805,24,-10,14,80,80,35,19,19,19,-5,5
193,0,-389,107,227,-451,227,-496,-507,-737,-1,12,11,27,3,-27,-62,-28,-36,-35,-47
115,4,-377,357,934,318,934,211,203,-30,-117,57,-60,-355,-170,-69,-140,-69,-60,57,0
61,26,-226,13,1197,-55,1256,-55,326,-55,5,11,16,60,29,29,53,42,32,27,16
-19,84,-78,45,1146,-109,1373,-109,143,-109,-1,-6,-7,-7,-7,-7,-1,-7,-7,-6,0
-93,188,-24,-46,355,-197,1226,-197,-4,-197,-24,-54,-78,2,-5,-48,-54,-49,-78,-54,0
38,58,-69,136,203,-182,1073,-182,11,-182,-2,-26,-28,-11,66,-9,-5,-5,-7,-5,21
-238,284,25,252,462,108,629,77,270,77,103,-13,90,74,74,74,86,82,76,-27,-14
67,20,-85,-51,170,-267,170,-267,-22,-267,1,-2,-1,1,-6,-6,-13,-6,-5,-6,-4
33,29,-208,-63,-2,-294,143,-294,-49,-294,1,-4,-3,-78,-72,-32,-32,-23,-14,-15,-11
49,63,-72,130,311,-12,425,-12,233,-12,-27,1,-26,-32,-32,-32,-1,-1,-27,0,-1
-17,64,-48,43,256,-127,256,-127,8,-127,27,10,37,-57,58,7,31,31,34,7,-3
148,38,-257,-13,271,-112,271,-112,23,-112,13,-29,-16,8,110,-19,-54,-14,-14,-27,2
-6,58,-137,-57,49,-287,241,-287,-7,-287,-10,-1,-11,-143,-97,-143,-42,-22,-22,-12,-11
-21,190,-132,-186,-98,-443,85,-443,-163,-443,-5,18,13,-16,10,10,72,37,37,42,24
57,39,-139,-141,57,-576,57,-576,-296,-576,-14,-34,-48,0,89,-61,-22,-39,-39,-25,9
45,29,-222,-59,107,-376,107,-526,-246,-526,-9,-2,-11,-151,-41,-11,-24,-16,-12,-3,-1
-143,301,17,303,533,204,533,-100,180,-100,-42,34,-8,116,27,66,5,15,-15,27,-7
30,58,-64,15,234,-264,252,-264,-101,-381,15,-7,8,-45,-36,-6,-2,-19,-11,-26,-19
-176,491,-14,-16,140,-298,218,-298,-135,-415,0,0,0,1,0,0,0,0,0,0,0
19,157,-32,-36,51,-738,51,-738,-575,-855,9,26,35,135,172,140,160,-11,18,9,-17
138,24,-311,-169,-136,-831,-136,-1031,-853,-1148,-22,-6,-28,-14,-33,-72,-14,-33,-33,-11,-5
-10,153,-86,-104,143,-628,143,-912,-734,-1029,168,-156,12,86,86,86,54,36,24,-144,12
-64,261,12,182,288,-71,288,-577,-549,-777,-16,-20,-36,-77,-29,-19,21,-12,-15,1,21
-80,139,-115,63,142,-203,142,-639,-639,-923,-1,2,1,-25,59,30,-7,-107,0,1,-1
-85,664,-32,203,400,124,400,41,-381,-665,-20,8,-12,49,49,31,-16,-19,-17,3,-5
-70,231,-7,90,204,-492,204,-492,-841,-1125,0,5,5,113,113,5,5,5,5,5,0
108,305,154,226,458,-265,458,-265,-614,-898,0,5,5,-79,28,-46,19,19,17,17,12
-5,272,4,20,629,-94,629,-94,-405,-527,-15,7,-8,8,-16,1,8,10,1,16,9
-42,168,-74,94,656,31,656,-67,89,-416,30,-19,11,33,0,-39,-32,-21,28,-2,17
-50,138,-19,56,544,-33,697,-33,209,-33,-40,1,-39,-61,-59,-48,-14,-39,-31,9,8
-244,12,-332,-154,131,-242,488,-242,-71,-242,-2,15,13,-50,-10,-1,0,42,12,14,-1
-198,41,-379,3,-375,-719,-52,-719,-458,-719,29,51,80,0,0,419,398,193,83,54,3
42,58,-195,-72,-145,-905,-145,-905,-644,-905,14,0,14,-17,51,50,19,23,19,5,5
126,132,-56,116,179,-784,179,-784,-523,-784,-30,-12,-42,68,116,22,22,17,-30,0,12
29,182,-155,-48,351,-272,351,-612,-351,-612,10,0,10,4,-23,34,65,11,10,0,0
57,64,-276,-38,201,-305,201,-762,-501,-762,-38,11,-27,-190,-287,-238,-97,39,-28,10,-1
-101,280,-1,97,364,-95,411,-212,-291,-552,29,6,35,178,160,144,130,50,58,29,23
164,-129,-566,-228,-81,-456,50,-456,-652,-913,16,41,57,69,69,69,69,68,65,49,8
-59,383,63,175,266,-219,350,-219,-305,-566,-4,-1,-5,-94,26,6,-4,-4,-4,0,1
-156,312,92,210,557,-45,557,-45,-131,-392,0,-30,-30,-80,-80,-80,-80,-79,-30,-30,0
-41,23,-190,-43,367,-235,367,-235,-238,-582,14,23,37,-20,28,-20,-2,19,17,3,-20
-37,233,-220,-95,508,-49,508,-94,164,-101,1,1,2,10,20,10,1,6,1,0,-1
54,135,-117,123,184,-299,429,-299,85,-299,50,-3,47,192,12,19,92,80,70,20,23
67,-3,-205,-68,141,-312,416,-312,72,-312,-17,-5,-22,-52,-21,-127,-21,-21,-21,-4,1
-293,217,-11,73,290,-163,320,-163,146,-163,-12,-7,-19,38,47,-22,-19,-13,-19,-7,0
-21,-91,-549,-122,-258,-585,-239,-692,-383,-692,55,-9,46,61,147,65,73,88,44,-11,-2
-82,-427,-648,-441,-707,-1201,-707,-1308,-999,-1308,-27,18,-9,-292,-292,-217,-67,3,-4,23,5
-2,94,-94,35,-463,-1201,-463,-1237,-1035,-1344,50,-2,48,35,109,95,47,47,47,-3,-1
57,194,70,71,207,-1088,207,-1124,-922,-1231,0,-3,-3,2,59,35,55,2,2,2,5
38,-554,-715,-623,-373,-1151,-373,-1668,-1502,-1811,-12,-19,-31,-210,-82,-63,33,22,-20,-8,11
-105,164,-89,59,-347,-689,-347,-1642,-1476,-1785,24,6,30,59,217,46,46,46,35,11,5
44,151,-251,97,-48,-901,-48,-1337,-1688,-1997,1,-12,-11,63,51,30,23,23,-5,-6,6
51,280,116,172,361,-691,361,-691,-1478,-1680,-1,-9,-10,4,67,4,5,4,3,4,13
-58,259,-19,103,487,35,487,-565,-1352,-1554,-23,-13,-36,30,-129,27,-6,-30,-36,-13,0
164,81,-108,33,404,-102,404,-648,-1364,-1601,36,-30,6,-4,-4,-4,-4,-4,32,-4,26
21,480,-8,88,766,335,847,335,-700,-1158,-3,-9,-12,88,87,88,88,23,-5,-2,7
-130,295,-58,-20,867,240,1095,240,-172,-393,5,-12,-7,-7,-7,38,-2,-7,-7,-12,0
19,223,16,128,822,-8,1064,-8,254,-8,-10,-7,-17,4,4,7,15,4,-18,-8,-1
174,143,-57,29,843,57,982,57,288,57,30,-26,4,304,195,148,75,40,28,-2,24
-95,209,2,60,646,179,1123,179,379,179,36,-36,0,39,27,39,2,8,-3,-39,-3
74,130,-42,-17,499,-23,1054,-23,184,-23,0,14,14,85,38,34,-1,14,14,14,0
-43,54,-162,-77,349,-47,616,-47,125,-47,-14,-8,-22,-98,-71,-66,-27,-26,-23,-9,-1
-149,488,-13,364,358,17,673,17,233,17,-8,-32,-40,-117,-62,-162,-67,-48,-42,-34,-2
-266,190,-45,64,395,-106,435,-106,140,-106,10,0,10,76,63,35,35,15,15,5,5
-6,99,-298,-34,94,-407,94,-407,-161,-407,-13,4,-9,-344,-206,-206,-156,-156,-119,-106,-110
94,116,-205,-8,40,-466,40,-466,-220,-466,-21,-2,-23,30,-15,-15,-35,-35,-36,-15,-13
145,95,-154,-55,131,-390,131,-451,-205,-451,-32,-43,-75,-300,-300,-201,-140,-140,-120,-88,-45
64,517,-22,-2,619,146,619,37,283,37,-78,51,-27,-8,-12,-12,-8,-7,0,78,27
127,-123,-416,-286,352,-289,352,-289,16,-289,-2,-10,-12,0,0,334,153,21,1,3,13
99,84,-262,23,240,-492,276,-492,-199,-492,-9,29,20,245,185,115,115,60,34,43,14
-127,317,17,121,479,-187,581,-187,106,-187,-42,17,-25,500,150,50,0,-12,-30,12,-5
98,81,-303,-22,149,-427,305,-427,-134,-427,49,20,69,-83,-83,-50,-65,89,70,21,1
78,225,-31,63,328,-124,418,-248,45,-248,-23,-17,-40,-11,-10,0,-21,-43,-41,-18,-1
-110,-162,-420,-241,-79,-463,-11,-587,-294,-587,42,-75,-33,50,50,50,40,-13,-30,-72,3
31,40,-229,-45,-289,-673,-221,-673,-504,-797,52,-16,36,182,38,14,-25,29,36,-16,0
-91,-79,-249,-194,-69,-739,-69,-782,-613,-906,11,-2,9,-24,-24,-24,11,3,3,-8,-6
13,-32,-229,-86,-280,-950,-280,-993,-824,-1117,52,-21,31,320,214,170,160,70,70,18,39
55,-120,-432,-157,-258,-775,-258,-1176,-1050,-1343,2,16,18,-36,-119,-105,0,0,12,10,-6
118,-205,-385,-255,-464,-1030,-464,-1520,-1394,-1687,49,27,76,250,150,150,150,90,70,21,-6
-5,112,-66,80,18,-576,18,-896,-1039,-1340,3,-3,0,19,-8,-6,3,3,3,0,3
-116,162,-2,33,227,-438,227,-692,-924,-1225,10,15,25,58,32,32,32,32,28,18,3
45,-92,-252,-175,-3,-277,-3,-691,-1154,-1455,-5,-6,-11,-12,-12,-42,-12,-11,-11,-6,0
-31,70,-278,22,-189,-438,-189,-854,-1340,-1598,5,10,15,195,106,90,27,16,22,17,7
-51,550,244,260,592,84,592,59,-818,-1076,-60,24,-36,31,-34,-106,-83,-55,-55,5,-19
19,171,-147,-90,619,111,619,111,-389,-648,1,10,11,20,22,20,14,5,2,1,-9
68,238,96,200,837,71,837,71,-171,-341,-47,131,84,-47,-111,-9,-9,79,79,126,-5
44,-16,-174,-41,678,-46,720,-46,-30,-227,0,0,0,139,135,132,112,-38,11,11,11
126,100,-123,-3,250,-196,698,-196,-38,-226,-59,-37,-96,192,100,40,11,-20,-96,-37,0
-124,346,29,105,466,170,1022,170,328,170,-22,-66,-88,-84,-84,-84,-139,-84,-79,-57,9
127,120,-71,-10,430,-7,580,-7,292,-7,10,-50,-40,375,150,138,-21,-19,-10,-20,30
-52,345,30,63,776,275,776,275,466,275,0,-42,-42,24,6,-27,-4,-30,-30,-30,12
72,154,-19,37,731,105,851,105,420,105,2,-17,-15,218,123,73,-17,-17,-17,-19,-2
20,-7,-231,-35,509,-51,819,-51,122,-51,12,-10,2,-21,7,-21,30,-21,-6,-18,-8
-74,-35,-180,-110,289,-330,600,-330,-106,-330,21,35,56,117,100,78,84,49,56,35,0
48,52,-160,-45,-42,-395,345,-395,-171,-395,-5,42,37,0,-91,15,19,22,0,5,-37
193,373,58,78,405,-42,577,-42,182,-42,0,0,0,-22,58,-22,-22,-21,-12,-12,-12
-107,324,22,118,681,334,681,234,458,234,-8,-7,-15,-206,-155,-97,-76,24,-26,-18,-11
-38,448,-99,-89,883,224,883,224,526,224,0,0,0,0,0,0,0,0,0,0,0
153,-14,-322,-71,589,-361,621,-361,186,-361,-15,13,-2,-226,-75,-26,-26,-26,-15,0,-13
-141,198,-28,12,427,-198,784,-198,149,-198,30,-23,7,105,87,-3,46,-35,17,-13,10
192,13,-478,-13,-95,-642,308,-642,-295,-642,5,4,9,143,232,173,8,7,9,4,0
-29,152,-140,49,115,-501,115,-540,-193,-540,-7,-60,-67,80,-55,22,-108,-38,-55,-48,12
55,150,-59,34,184,-344,184,-508,-161,-508,-13,16,3,27,27,-8,-129,-79,-73,-60,-76
-143,217,3,93,237,-291,237,-416,-108,-455,-19,36,17,-85,-23,-20,-23,-20,11,30,-6
-16,41,-321,33,-92,-384,-92,-620,-437,-784,6,-6,0,25,2,2,2,2,1,-5,1
-120,-245,-358,-313,-230,-606,-230,-891,-708,-1055,-94,104,10,-33,3,3,-170,-25,-67,27,-77
-7,-32,-449,-54,-564,-931,-564,-989,-1042,-1389,12,-2,10,146,146,146,146,96,8,-4,-2
-12,109,-15,44,51,-843,51,-857,-959,-1306,-53,57,4,-18,-18,-1,-21,4,-4,49,-8
-151,522,45,82,510,-208,510,-447,-558,-866,0,0,0,164,0,118,130,100,82,82,82
104,-5,-504,-26,-47,-534,-47,-1011,-1078,-1310,17,-11,6,211,211,111,51,54,8,-9,2
-151,164,-96,-25,183,-336,183,-589,-631,-1122,15,-7,8,-37,-6,37,19,19,19,4,11
-117,67,-420,-25,-66,-585,-66,-595,-877,-1135,16,14,30,71,55,44,70,67,70,54,40
11,152,-129,81,-43,-675,-43,-695,-987,-1196,0,0,0,-22,-22,-22,0,0,0,0,0
62,12,-206,-59,80,-602,80,-767,-1045,-1259,37,-4,33,143,41,3,-61,-59,41,4,8
-105,267,18,94,282,-400,282,-545,-705,-1052,-1,-11,-12,82,144,40,60,-30,-18,-17,-6
-4,541,-129,33,663,377,663,-19,-324,-437,10,-165,-155,109,-117,-117,-41,-99,-89,-99,66
-15,176,30,81,777,0,792,0,352,-65,7,86,93,-80,79,25,39,59,85,78,-8
41,327,-20,144,1027,250,1042,250,426,195,14,9,23,-275,-75,-54,-56,-25,10,-4,-13
-36,13,-207,-77,863,-77,970,-77,270,-77,-10,73,63,-73,143,133,73,80,43,53,-20
-221,301,111,124,595,19,1196,19,239,19,35,-5,30,-96,61,36,36,-31,4,-31,-26
93,300,5,116,487,10,1080,10,230,10,59,32,91,44,43,45,45,67,88,29,-3
49,92,-121,-35,298,3,584,3,228,3,-2,53,51,-172,-132,-3,-62,-2,9,11,-42
112,325,64,106,510,91,697,91,304,91,0,10,10,-26,-23,-46,-18,-23,0,0,-10
-20,147,-50,57,582,136,582,136,376,136,0,64,64,67,-27,-26,42,64,59,59,-5
14,177,59,108,464,17,649,17,214,17,-10,30,20,-61,-50,1,7,4,14,24,-6
-17,-35,-316,-115,258,-189,443,-189,-29,-189,0,79,79,-156,-62,113,103,74,74,74,-5
-40,162,58,86,69,-255,319,-255,26,-255,0,48,48,81,73,49,61,34,44,44,-4
101,102,-185,21,162,-255,319,-255,26,-255,-22,30,8,34,33,9,24,2,2,24,-6
68,158,-91,63,231,-186,231,-186,95,-186,0,53,53,41,0,43,43,43,24,24,-29
-100,272,68,192,370,23,370,-47,234,-47,10,10,20,-38,32,32,32,22,20,10,0
-99,162,-93,33,345,58,405,-12,269,-12,0,-10,-10,0,0,17,-15,-13,-13,-13,-3
42,71,-90,46,233,-192,306,-192,63,-192,0,38,38,-62,-9,38,40,38,38,38,0
-71,237,67,150,305,-95,343,-95,160,-95,-2,-14,-16,-1,-5,-3,-15,-10,-12,-10,4
56,198,-154,190,82,-250,175,-250,5,-250,-5,75,70,-149,-28,24,4,80,50,55,-20
-124,193,59,101,327,-25,327,-121,134,-121,0,13,13,-86,-11,-6,11,18,9,9,-4
-51,211,-121,-32,363,11,363,-85,170,-85,-12,8,-4,-122,-42,-42,-35,-15,-7,5,-3
26,24,-95,-56,268,-216,268,-216,75,-216,14,0,14,-80,89,78,46,20,0,-14,-14
129,55,-151,-108,119,-231,253,-231,9,-231,-2,33,31,-15,-15,-15,53,45,33,35,2
16,213,-169,-48,267,-65,419,-65,175,-65,-25,5,-20,-49,-35,-35,-35,-35,-25,0,-5
-20,7,-130,-46,192,-198,256,-198,146,-198,-2,-56,-58,144,-58,-58,-58,-58,-58,-56,0
24,40,-112,-55,121,-269,167,-269,-64,-269,20,0,20,71,58,31,31,24,21,1,1
-108,235,57,162,347,-35,355,-35,170,-35,5,3,8,-120,45,29,35,1,6,1,-2
